{
    "1": {
        "tubes": [
            [1],
            [1,1,1]
        ]
    },
    "2": {
        "tubes": [
            [1, 2, 1, 2],
            [2, 1, 2, 1],
            []
        ]
    },
    "3": {
        "tubes": [
            [1, 2, 3, 1],
            [2, 2, 3, 1],
            [3, 1, 2, 3],
            [],
            []
        ]
    },
    "4": {
        "tubes": [
            [1, 2, 3, 3],
            [1, 2, 1, 2],
            [3, 1, 2, 3],
            [],
            []
        ]
    },
    "5": {
        "tubes": [
            [1, 2, 3, 4],
            [2, 1, 3, 4],
            [4, 5, 2, 5],
            [2, 4, 5, 3],
            [1, 1, 5, 3],
            [],
            []
        ]
    },
    "6": {
        "tubes": [
            [1, 2, 2, 2],
            [3, 1, 4, 2],
            [4, 3, 1, 3],
            [5, 4, 3, 4],
            [5, 5, 5, 1],
            [],
            []
        ]
    },
    "7": {
        "tubes": [
            [1, 2, 3, 2],
            [4, 4, 3, 2],
            [5, 5, 4, 2],
            [1, 5, 3, 4],
            [1, 3, 1, 5],
            [],
            []
        ]
    },
    "8": {
        "tubes": [
            [1, 2, 1, 3],
            [2, 4, 4, 2],
            [4, 5, 3, 5],
            [3, 5, 1, 4],
            [3, 1, 5, 2],
            [],
            []
        ]
    },
    "9": {
        "tubes": [
            [1, 2, 3, 1],
            [2, 4, 4, 5],
            [2, 5, 5, 1],
            [1, 2, 4, 3],
            [4, 5, 3, 3],
            [],
            []
        ]
    },
    "10": {
        "tubes": [
            [1, 2, 3, 2],
            [4, 5, 1, 6],
            [2, 7, 7, 3],
            [1, 4, 4, 3],
            [5, 5, 3, 6],
            [2, 6, 7, 7],
            [6, 1, 4, 5],
            [],
            []
        ]
    },
    "11": {
        "tubes": [
            [1, 2, 1, 3],
            [2, 2, 4, 3],
            [5, 5, 6, 5],
            [3, 7, 2, 5],
            [1, 4, 7, 6],
            [6, 1, 7, 7],
            [6, 3, 4, 4],
            [],
            []
        ]
    },
    "12": {
        "tubes": [
            [1, 2, 3, 3],
            [4, 1, 2, 1],
            [1, 4, 5, 3],
            [4, 3, 5, 2],
            [5, 4, 5, 2],
            [],
            []
        ]
    },
    "13": {
        "tubes": [
            [1, 2, 3, 4],
            [5, 3, 3, 6],
            [2, 7, 5, 4],
            [3, 4, 1, 6],
            [6, 2, 7, 6],
            [2, 5, 1, 7],
            [7, 4, 1, 5],
            [],
            []
        ]
    },
    "14": {
        "tubes": [
            [1, 2, 2, 2],
            [2, 1, 3, 4],
            [1, 4, 1, 5],
            [6, 4, 5, 3],
            [6, 7, 3, 6],
            [4, 7, 5, 7],
            [3, 5, 7, 6],
            [],
            []
        ]
    },
    "15": {
        "tubes": [
            [1, 2, 2, 3],
            [4, 1, 5, 4],
            [4, 1, 4, 3],
            [5, 5, 3, 1],
            [3, 2, 5, 2],
            [],
            []
        ]
    },
    "16": {
        "tubes": [
            [1, 2, 2, 1],
            [3, 1, 4, 1],
            [5, 6, 5, 5],
            [7, 4, 6, 7],
            [6, 3, 7, 5],
            [3, 7, 2, 3],
            [2, 4, 4, 6],
            [],
            []
        ]
    },
    "17": {
        "tubes": [
            [1, 2, 3, 1],
            [4, 3, 5, 6],
            [3, 4, 6, 3],
            [1, 5, 2, 7],
            [6, 7, 1, 6],
            [5, 4, 7, 5],
            [7, 4, 2, 2],
            [],
            []
        ]
    },
    "18": {
        "tubes": [
            [1, 2, 3, 4],
            [2, 5, 4, 1],
            [2, 3, 4, 1],
            [5, 3, 3, 1],
            [5, 5, 4, 2],
            [],
            []
        ]
    },
    "19": {
        "tubes": [
            [1, 2, 3, 3],
            [1, 4, 3, 4],
            [5, 6, 7, 7],
            [6, 3, 1, 7],
            [5, 1, 4, 2],
            [5, 5, 4, 7],
            [6, 6, 2, 2],
            [],
            []
        ]
    },
    "20": {
        "tubes": [
            [1, 1, 2, 3],
            [2, 3, 4, 3],
            [5, 6, 5, 7],
            [6, 7, 4, 5],
            [1, 1, 4, 7],
            [5, 2, 6, 4],
            [7, 6, 2, 3],
            [],
            []
        ]
    },
    "21": {
        "tubes": [
            [1, 2, 2, 3],
            [4, 5, 2, 1],
            [3, 3, 5, 2],
            [5, 1, 4, 3],
            [1, 4, 5, 4],
            [],
            []
        ]
    },
    "22": {
        "tubes": [
            [1, 1, 2, 3],
            [4, 5, 6, 7],
            [5, 3, 6, 2],
            [4, 2, 5, 7],
            [4, 6, 7, 7],
            [3, 1, 2, 1],
            [3, 4, 5, 6],
            [],
            []
        ]
    },
    "23": {
        "tubes": [
            [1, 2, 3, 4],
            [3, 2, 5, 6],
            [4, 7, 4, 6],
            [3, 1, 5, 6],
            [3, 7, 2, 6],
            [7, 1, 1, 2],
            [5, 5, 4, 7],
            [],
            []
        ]
    },
    "24": {
        "tubes": [
            [1, 2, 2, 2],
            [3, 3, 4, 4],
            [3, 1, 5, 4],
            [1, 3, 4, 5],
            [5, 1, 5, 2],
            [],
            []
        ]
    },
    "25": {
        "tubes": [
            [1, 1, 2, 3],
            [4, 5, 2, 3],
            [5, 5, 6, 1],
            [6, 4, 4, 7],
            [6, 7, 2, 7],
            [7, 3, 2, 5],
            [1, 4, 3, 6],
            [],
            []
        ]
    },
    "26": {
        "tubes": [
            [1, 2, 3, 3],
            [4, 5, 5, 4],
            [6, 7, 1, 4],
            [5, 7, 6, 2],
            [1, 6, 5, 4],
            [2, 2, 1, 3],
            [3, 7, 7, 3],
            [],
            []
        ]
    },
    "27": {
        "tubes": [
            [1, 1, 2, 3],
            [2, 4, 4, 5],
            [1, 2, 3, 3],
            [3, 5, 5, 4],
            [5, 2, 4, 1],
            [],
            []
        ]
    },
    "28": {
        "tubes": [
            [1, 2, 3, 4],
            [5, 5, 6, 5],
            [1, 2, 7, 2],
            [7, 4, 5, 6],
            [4, 4, 3, 2],
            [6, 1, 1, 3],
            [3, 7, 7, 6],
            [],
            []
        ]
    },
    "29": {
        "tubes": [
            [1, 2, 3, 4],
            [2, 5, 5, 3],
            [6, 4, 6, 4],
            [3, 2, 5, 6],
            [1, 7, 5, 6],
            [2, 1, 1, 7],
            [7, 4, 7, 3],
            [],
            []
        ]
    },
    "30": {
        "tubes": [
            [1, 2, 2, 2],
            [3, 3, 4, 5],
            [1, 6, 3, 2],
            [6, 7, 1, 5],
            [6, 7, 4, 7],
            [3, 4, 5, 4],
            [7, 6, 1, 5],
            [],
            []
        ]
    }
}